11111111111111111111
11111111111111111111
11000000000000000111
11111111111111110111
11111111111111110111
11111111111111110111
11111111111111110111
11111110000000000111
11111110222222222222
11111110222222222222