1111111111111111111
1222222221222222221
1511211121211121151
1222222222222222221
1211212111112121121
1222212221222122221
1111211101011121111
   1210000000121
1111210111110121111
0000200100010020000
1111210111110121111
   1210000000121
1111210111110121111
1222212221222122221
1211211121211121121
1521222223222221251
1121212111112121211
1222212221222122221
1211111121211111121
1222222222222222221
1111111111111111111
